%%%%%%%%%%%%%%%%%%%%%%%%%%%%%%%%
%                              %
%                              %
%                              %
%                              %
%                              %
%                           %  %
%   P                       %o.%
%                           %  %
%                              %
%                              %
%                              %
%                              %
%%%%%%%%%%%%%%%%%%%%%%%%%%%%%%%%