%%%%%%%%%%%%%%%%%%%%%%%%%%%%%%%%%%
%                                %
%                                %
%    P                        o. %
%                                %
%                                %
%%%%%%%%%%%%%%%%%%%%%%%%%%%%%%%%%%